"být<br><br>Je hezké <span style=""color:#06c; font-weight:bold;"">být</span> doma v teple."	"to be<br><br>It is nice <span style=""color:#06c; font-weight:bold;"">to be</span> at home in the warmth."
"a<br><br>Mám psa <span style=""color:#06c; font-weight:bold;"">a</span> kočku."	"and<br><br>I have a dog <span style=""color:#06c; font-weight:bold;"">and</span> a cat."
"se<br><br>On <span style=""color:#06c; font-weight:bold;"">se</span> učí poznávat sám sebe."	oneself<br><br>He is learning to know himself.
"v<br><br><span style=""color:#06c; font-weight:bold;"">V</span> létě rád spím v hamace."	"in<br><br><span style=""color:#06c; font-weight:bold;"">In</span> summer I like to sleep in a hammock."
"na<br><br>Klíče leží <span style=""color:#06c; font-weight:bold;"">na</span> stole."	"on<br><br>The keys are lying <span style=""color:#06c; font-weight:bold;"">on</span> the table."
"ten<br><br><span style=""color:#06c; font-weight:bold;"">Ten</span> film byl opravdu zábavný."	"that<br><br><span style=""color:#06c; font-weight:bold;"">That</span> movie was really fun."
"s<br><br>Jdu <span style=""color:#06c; font-weight:bold;"">s</span> kamarádem na kávu."	"with<br><br>I am going for coffee <span style=""color:#06c; font-weight:bold;"">with</span> a friend."
"že<br><br>Myslím, <span style=""color:#06c; font-weight:bold;"">že</span> máš pravdu."	"that<br><br>I think <span style=""color:#06c; font-weight:bold;"">that</span> you are right."
"on<br><br><span style=""color:#06c; font-weight:bold;"">On</span> dnes vaří večeři."	"he<br><br><span style=""color:#06c; font-weight:bold;"">He</span> is cooking dinner today."
"z<br><br>Přijel <span style=""color:#06c; font-weight:bold;"">z</span> práce pozdě."	"from<br><br>He came <span style=""color:#06c; font-weight:bold;"">from</span> work late."
"který<br><br>To je dům, <span style=""color:#06c; font-weight:bold;"">který</span> se mi líbí."	"which<br><br>That is the house <span style=""color:#06c; font-weight:bold;"">which</span> I like."
"mít<br><br>Chci <span style=""color:#06c; font-weight:bold;"">mít</span> víc volného času."	"to have<br><br>I want <span style=""color:#06c; font-weight:bold;"">to have</span> more free time."
"do<br><br>Večer jdu <span style=""color:#06c; font-weight:bold;"">do</span> kina."	"to<br><br>In the evening I am going <span style=""color:#06c; font-weight:bold;"">to</span> the cinema."
"o<br><br>Mluvíme <span style=""color:#06c; font-weight:bold;"">o</span> našem víkendu."	"about<br><br>We are talking <span style=""color:#06c; font-weight:bold;"">about</span> our weekend."
"ale<br><br>Je unavený, <span style=""color:#06c; font-weight:bold;"">ale</span> šťastný."	"but<br><br>He is tired <span style=""color:#06c; font-weight:bold;"">but</span> happy."
"k<br><br>Musím jít <span style=""color:#06c; font-weight:bold;"">k</span> zubaři."	"to<br><br>I have <span style=""color:#06c; font-weight:bold;"">to</span> go to the dentist."
"i<br><br>Přijdeš <span style=""color:#06c; font-weight:bold;"">i</span> ty na oslavu?"	"also<br><br>Are you <span style=""color:#06c; font-weight:bold;"">also</span> coming to the party?"
"já<br><br><span style=""color:#06c; font-weight:bold;"">Já</span> dnes uklízím celý byt."	"I<br><br>Today <span style=""color:#06c; font-weight:bold;"">I</span> am cleaning the whole flat."
"jako<br><br>Voní <span style=""color:#06c; font-weight:bold;"">jako</span> čerstvý chléb."	"like<br><br>It smells <span style=""color:#06c; font-weight:bold;"">like</span> fresh bread."
moci<br><br>Zítra nemohu přijít.	can<br><br>I cannot come tomorrow.
"svůj<br><br>Každý má <span style=""color:#06c; font-weight:bold;"">svůj</span> malý sen."	one's own<br><br>Everyone has their own little dream.
"za<br><br>Auto stojí <span style=""color:#06c; font-weight:bold;"">za</span> domem."	"behind<br><br>The car is parked <span style=""color:#06c; font-weight:bold;"">behind</span> the house."
"pro<br><br>Mám dárek <span style=""color:#06c; font-weight:bold;"">pro</span> tebe."	"for<br><br>I have a present <span style=""color:#06c; font-weight:bold;"">for</span> you."
"rok<br><br>Tento <span style=""color:#06c; font-weight:bold;"">rok</span> hodně cestuji."	"year<br><br>This <span style=""color:#06c; font-weight:bold;"">year</span> I travel a lot."
"tak<br><br>Byl <span style=""color:#06c; font-weight:bold;"">tak</span> nervózní, že se třásl."	"so<br><br>He was <span style=""color:#06c; font-weight:bold;"">so</span> nervous that he was shaking."
"po<br><br><span style=""color:#06c; font-weight:bold;"">Po</span> práci jdu na pivo."	"after<br><br><span style=""color:#06c; font-weight:bold;"">After</span> work I am going for a beer."
"oni<br><br><span style=""color:#06c; font-weight:bold;"">Oni</span> bydlí vedle školy."	"they<br><br><span style=""color:#06c; font-weight:bold;"">They</span> live next to the school."
"co<br><br><span style=""color:#06c; font-weight:bold;"">Co</span> děláš dnes večer?"	"what<br><br><span style=""color:#06c; font-weight:bold;"">What</span> are you doing tonight?"
"když<br><br>Usnul, <span style=""color:#06c; font-weight:bold;"">když</span> četl knihu."	"when<br><br>He fell asleep <span style=""color:#06c; font-weight:bold;"">when</span> he was reading a book."
"tento<br><br><span style=""color:#06c; font-weight:bold;"">Tento</span> pokoj je moc tmavý."	"this<br><br><span style=""color:#06c; font-weight:bold;"">This</span> room is too dark."
"už<br><br>On <span style=""color:#06c; font-weight:bold;"">už</span> všechno ví."	"already<br><br>He <span style=""color:#06c; font-weight:bold;"">already</span> knows everything."
"všechen<br><br>Snědl <span style=""color:#06c; font-weight:bold;"">všechen</span> dort sám."	"all<br><br>He ate <span style=""color:#06c; font-weight:bold;"">all</span> the cake by himself."
"jak<br><br><span style=""color:#06c; font-weight:bold;"">Jak</span> se dnes cítíš?"	"how<br><br><span style=""color:#06c; font-weight:bold;"">How</span> do you feel today?"
"od<br><br>Mám dopis <span style=""color:#06c; font-weight:bold;"">od</span> babičky."	"from<br><br>I have a letter <span style=""color:#06c; font-weight:bold;"">from</span> my grandmother."
"aby<br><br>Šel dřív, <span style=""color:#06c; font-weight:bold;"">aby</span> nepřišel pozdě."	"so that<br><br>He left early <span style=""color:#06c; font-weight:bold;"">so that</span> he wouldn’t be late."
"nebo<br><br>Dáš si čaj <span style=""color:#06c; font-weight:bold;"">nebo</span> kávu?"	"or<br><br>Will you have tea <span style=""color:#06c; font-weight:bold;"">or</span> coffee?"
"jeho<br><br><span style=""color:#06c; font-weight:bold;"">Jeho</span> auto je před domem."	"his<br><br><span style=""color:#06c; font-weight:bold;"">His</span> car is in front of the house."
"jen<br><br>Mám <span style=""color:#06c; font-weight:bold;"">jen</span> tři minuty."	"only<br><br>I have <span style=""color:#06c; font-weight:bold;"">only</span> three minutes."
"jeden<br><br>Má jen <span style=""color:#06c; font-weight:bold;"">jeden</span> problém, ale velký."	"one<br><br>He has only <span style=""color:#06c; font-weight:bold;"">one</span> problem, but a big one."
"člověk<br><br>Každý <span style=""color:#06c; font-weight:bold;"">člověk</span> dělá občas chyby."	"person<br><br>Every <span style=""color:#06c; font-weight:bold;"">person</span> makes mistakes sometimes."
"u<br><br>Sejdeme se <span style=""color:#06c; font-weight:bold;"">u</span> školy v pět."	"at<br><br>We will meet <span style=""color:#06c; font-weight:bold;"">at</span> the school at five."
muset<br><br>Musím dnes vstát opravdu brzy.	"must<br><br>I <span style=""color:#06c; font-weight:bold;"">must</span> get up really early today."
"velký<br><br>Byl to <span style=""color:#06c; font-weight:bold;"">velký</span> úspěch pro tým."	"big<br><br>It was a <span style=""color:#06c; font-weight:bold;"">big</span> success for the team."
"chtít<br><br>Nechceš <span style=""color:#06c; font-weight:bold;"">chtít</span> méně práce?"	to want<br><br>Don’t you want less work?
"jenž<br><br>To je muž, <span style=""color:#06c; font-weight:bold;"">jenž</span> nám pomohl."	"who<br><br>That is the man <span style=""color:#06c; font-weight:bold;"">who</span> helped us."
"my<br><br><span style=""color:#06c; font-weight:bold;"">My</span> dnes vaříme večeři pro hosty."	"we<br><br><span style=""color:#06c; font-weight:bold;"">We</span> are cooking dinner for guests today."
"říci<br><br>Zapomněl jsem <span style=""color:#06c; font-weight:bold;"">říci</span> pravdu."	"to say<br><br>I forgot <span style=""color:#06c; font-weight:bold;"">to say</span> the truth."
"než<br><br>Jsem vyšší <span style=""color:#06c; font-weight:bold;"">než</span> můj bratr."	"than<br><br>I am taller <span style=""color:#06c; font-weight:bold;"">than</span> my brother."
"pak<br><br>Nejdřív uklidím, <span style=""color:#06c; font-weight:bold;"">pak</span> půjdu ven."	"then<br><br>First I’ll clean, <span style=""color:#06c; font-weight:bold;"">then</span> I’ll go out."
jít<br><br>Zítra jdu pěšky do práce.	to go<br><br>Tomorrow I am going to work on foot.
"při<br><br>Usnul <span style=""color:#06c; font-weight:bold;"">při</span> sledování filmu."	"during<br><br>He fell asleep <span style=""color:#06c; font-weight:bold;"">during</span> the movie."
"vědět<br><br>Chci <span style=""color:#06c; font-weight:bold;"">vědět</span>, co se stalo."	"to know<br><br>I want <span style=""color:#06c; font-weight:bold;"">to know</span> what happened."
"také<br><br>Rád čtu a <span style=""color:#06c; font-weight:bold;"">také</span> píšu příběhy."	"also<br><br>I like reading and I <span style=""color:#06c; font-weight:bold;"">also</span> write stories."
"dva<br><br>Máme doma <span style=""color:#06c; font-weight:bold;"">dva</span> psy a kočku."	"two<br><br>We have <span style=""color:#06c; font-weight:bold;"">two</span> dogs and a cat at home."
"další<br><br>Zítra mě čeká <span style=""color:#06c; font-weight:bold;"">další</span> test."	"another<br><br>Tomorrow <span style=""color:#06c; font-weight:bold;"">another</span> test is waiting for me."
"před<br><br>Stála <span style=""color:#06c; font-weight:bold;"">před</span> domem a mávala."	"in front of<br><br>She stood <span style=""color:#06c; font-weight:bold;"">in front of</span> the house and waved."
"stát<br><br>Přestal mluvit a začal <span style=""color:#06c; font-weight:bold;"">stát</span> tiše."	"to stand<br><br>He stopped talking and began <span style=""color:#06c; font-weight:bold;"">to stand</span> quietly."
"nový<br><br>Koupil jsem si <span style=""color:#06c; font-weight:bold;"">nový</span> telefon."	"new<br><br>I bought myself a <span style=""color:#06c; font-weight:bold;"">new</span> phone."
"vy<br><br><span style=""color:#06c; font-weight:bold;"">Vy</span> dnes pracujete z domova."	you (plural)<br><br>You (plural) are working from home today.
"celý<br><br>Přečetl jsem <span style=""color:#06c; font-weight:bold;"">celý</span> ten román."	"whole<br><br>I read the <span style=""color:#06c; font-weight:bold;"">whole</span> novel."
"ještě<br><br><span style=""color:#06c; font-weight:bold;"">Ještě</span> musím dopsat ten e‑mail."	"still<br><br>I <span style=""color:#06c; font-weight:bold;"">still</span> have to finish that email."
"ani<br><br>Neměl <span style=""color:#06c; font-weight:bold;"">ani</span> čas na snídani."	not even<br><br>He didn’t even have time for breakfast.
"hodně<br><br>Dnes je venku <span style=""color:#06c; font-weight:bold;"">hodně</span> lidí."	"a lot<br><br>There are <span style=""color:#06c; font-weight:bold;"">a lot</span> of people outside today."
"její<br><br><span style=""color:#06c; font-weight:bold;"">Její</span> sestra bydlí v Brně."	"her<br><br><span style=""color:#06c; font-weight:bold;"">Her</span> sister lives in Brno."
"jiný<br><br>Hledám <span style=""color:#06c; font-weight:bold;"">jiný</span> způsob, jak to udělat."	other<br><br>I’m looking for another way to do it.
"můj<br><br>Tohle je <span style=""color:#06c; font-weight:bold;"">můj</span> oblíbený hrnek."	"my<br><br>This is <span style=""color:#06c; font-weight:bold;"">my</span> favorite mug."
"první<br><br>Je to můj <span style=""color:#06c; font-weight:bold;"">první</span> den v práci."	"first<br><br>It is my <span style=""color:#06c; font-weight:bold;"">first</span> day at work."
"jejich<br><br><span style=""color:#06c; font-weight:bold;"">Jejich</span> dům je na kopci."	"their<br><br><span style=""color:#06c; font-weight:bold;"">Their</span> house is on a hill."
"až<br><br>Počkej tady, <span style=""color:#06c; font-weight:bold;"">až</span> se vrátím."	"until<br><br>Wait here <span style=""color:#06c; font-weight:bold;"">until</span> I come back."
"podle<br><br>Jedná <span style=""color:#06c; font-weight:bold;"">podle</span> svých zásad."	"according to<br><br>He acts <span style=""color:#06c; font-weight:bold;"">according to</span> his principles."
"dobrý<br><br>To byl opravdu <span style=""color:#06c; font-weight:bold;"">dobrý</span> nápad."	"good<br><br>That was a really <span style=""color:#06c; font-weight:bold;"">good</span> idea."
"mezi<br><br>Sedl si <span style=""color:#06c; font-weight:bold;"">mezi</span> kamarády do řady."	"between<br><br>He sat <span style=""color:#06c; font-weight:bold;"">between</span> his friends in the row."
"kde<br><br><span style=""color:#06c; font-weight:bold;"">Kde</span> jsi byl včera večer?"	"where<br><br><span style=""color:#06c; font-weight:bold;"">Where</span> were you last night?"
"ty<br><br><span style=""color:#06c; font-weight:bold;"">Ty</span> dnes vypadáš unaveně."	you (singular)<br><br>You look tired today.
"však<br><br>Chtěl jít ven, <span style=""color:#06c; font-weight:bold;"">však</span> pršelo."	"however<br><br>He wanted to go out, <span style=""color:#06c; font-weight:bold;"">however</span> it was raining."
"dát<br><br>Můžeš mi <span style=""color:#06c; font-weight:bold;"">dát</span> sklenici vody?"	to give<br><br>Can you give me a glass of water?
"tam<br><br>Venku je zima, ale v kavárně je <span style=""color:#06c; font-weight:bold;"">tam</span> teplo."	"there<br><br>It is cold outside, but it is warm <span style=""color:#06c; font-weight:bold;"">there</span> in the café."
"náš<br><br>To je <span style=""color:#06c; font-weight:bold;"">náš</span> pes Max."	"our<br><br>That is <span style=""color:#06c; font-weight:bold;"">our</span> dog Max."
"den<br><br>Měl jsem dnes dlouhý <span style=""color:#06c; font-weight:bold;"">den</span> v práci."	"day<br><br>I had a long <span style=""color:#06c; font-weight:bold;"">day</span> at work today."
"každý<br><br><span style=""color:#06c; font-weight:bold;"">Každý</span> den se učím trochu češtiny."	"every<br><br><span style=""color:#06c; font-weight:bold;"">Every</span> day I study a bit of Czech."
"něco<br><br>Mám pro tebe <span style=""color:#06c; font-weight:bold;"">něco</span> malého."	"something<br><br>I have <span style=""color:#06c; font-weight:bold;"">something</span> small for you."
"doba<br><br>To byla těžká <span style=""color:#06c; font-weight:bold;"">doba</span> pro rodinu."	"period<br><br>It was a hard <span style=""color:#06c; font-weight:bold;"">period</span> for the family."
druhý<br><br>Bydlíme v druhém patře.	"second<br><br>We live on the <span style=""color:#06c; font-weight:bold;"">second</span> floor."
"protože<br><br>Zůstanu doma, <span style=""color:#06c; font-weight:bold;"">protože</span> jsem nemocný."	"because<br><br>I’ll stay at home <span style=""color:#06c; font-weight:bold;"">because</span> I am sick."
"dítě<br><br><span style=""color:#06c; font-weight:bold;"">Dítě</span> spí v kočárku."	"child<br><br>The <span style=""color:#06c; font-weight:bold;"">child</span> is sleeping in the stroller."
"ne<br><br>Řekl jsem <span style=""color:#06c; font-weight:bold;"">ne</span> a odešel."	"no<br><br>I said <span style=""color:#06c; font-weight:bold;"">no</span> and left."
"takový<br><br>To je <span style=""color:#06c; font-weight:bold;"">takový</span> zvláštní pocit."	"such<br><br>It is <span style=""color:#06c; font-weight:bold;"">such</span> a strange feeling."
"vidět<br><br>Chci <span style=""color:#06c; font-weight:bold;"">vidět</span> moře naživo."	"to see<br><br>I want <span style=""color:#06c; font-weight:bold;"">to see</span> the sea in real life."
říkat<br><br>Rodiče mi často říkají pravdu na rovinu.	to say repeatedly<br><br>My parents often tell me the truth directly.
"nic<br><br>Dnes se mi nechce dělat <span style=""color:#06c; font-weight:bold;"">nic</span>."	nothing<br><br>Today I don’t feel like doing anything.
"začít<br><br>Rozhodl se <span style=""color:#06c; font-weight:bold;"">začít</span> nový projekt."	"to start<br><br>He decided <span style=""color:#06c; font-weight:bold;"">to start</span> a new project."
"život<br><br><span style=""color:#06c; font-weight:bold;"">Život</span> ve městě je rychlý."	"life<br><br><span style=""color:#06c; font-weight:bold;"">Life</span> in the city is fast."
"český<br><br>Poslouchám <span style=""color:#06c; font-weight:bold;"">český</span> podcast pro začátečníky."	"Czech<br><br>I listen to a <span style=""color:#06c; font-weight:bold;"">Czech</span> podcast for beginners."
"místo<br><br>Najdeme jiné <span style=""color:#06c; font-weight:bold;"">místo</span> k sezení."	"place<br><br>We will find another <span style=""color:#06c; font-weight:bold;"">place</span> to sit."
"či<br><br>Máš čaj <span style=""color:#06c; font-weight:bold;"">či</span> kávu?"	or (formal)<br><br>Do you have tea or coffee?
malý<br><br>Bydlí v malém bytě v centru.	"small<br><br>He lives in a <span style=""color:#06c; font-weight:bold;"">small</span> flat in the center."
"bez<br><br>Nepůjdu nikam <span style=""color:#06c; font-weight:bold;"">bez</span> telefonu."	"without<br><br>I won’t go anywhere <span style=""color:#06c; font-weight:bold;"">without</span> my phone."
ruka<br><br>Podal mi ruku na pozdrav.	"hand<br><br>He gave me his <span style=""color:#06c; font-weight:bold;"">hand</span> in greeting."
"nějaký<br><br>Potřebuji <span style=""color:#06c; font-weight:bold;"">nějaký</span> čas pro sebe."	"some<br><br>I need <span style=""color:#06c; font-weight:bold;"">some</span> time for myself."
"kdy<br><br><span style=""color:#06c; font-weight:bold;"">Kdy</span> máš zítra čas?"	"when<br><br><span style=""color:#06c; font-weight:bold;"">When</span> do you have time tomorrow?"
"sám<br><br>On rád pracuje <span style=""color:#06c; font-weight:bold;"">sám</span> v tichu."	"alone<br><br>He likes to work <span style=""color:#06c; font-weight:bold;"">alone</span> in silence."
"teď<br><br><span style=""color:#06c; font-weight:bold;"">Teď</span> musím odepsat na zprávu."	"now<br><br><span style=""color:#06c; font-weight:bold;"">Now</span> I have to reply to a message."
"pokud<br><br><span style=""color:#06c; font-weight:bold;"">Pokud</span> bude zítra hezky, půjdeme na výlet."	"if<br><br><span style=""color:#06c; font-weight:bold;"">If</span> the weather is nice tomorrow, we will go on a trip."
"dobře<br><br>Nerozumím tomu moc <span style=""color:#06c; font-weight:bold;"">dobře</span>."	"well<br><br>I don’t understand it very <span style=""color:#06c; font-weight:bold;"">well</span>."
"dostat<br><br>Potřebuju <span style=""color:#06c; font-weight:bold;"">dostat</span> novou občanku."	"to get<br><br>I need <span style=""color:#06c; font-weight:bold;"">to get</span> a new ID card."
myslet<br><br>Myslíš na tu zkoušku každý den?	to think<br><br>Do you think about that exam every day?
"práce<br><br>Moje <span style=""color:#06c; font-weight:bold;"">práce</span> začíná v osm ráno."	"work<br><br>My <span style=""color:#06c; font-weight:bold;"">work</span> starts at eight in the morning."
"pod<br><br>Kočka spí <span style=""color:#06c; font-weight:bold;"">pod</span> stolem."	"under<br><br>The cat is sleeping <span style=""color:#06c; font-weight:bold;"">under</span> the table."
strana<br><br>Sedla si na druhou stranu stolu.	"side<br><br>She sat on the other <span style=""color:#06c; font-weight:bold;"">side</span> of the table."
"svět<br><br>Chtěl by procestovat celý <span style=""color:#06c; font-weight:bold;"">svět</span>."	"world<br><br>He would like to travel around the whole <span style=""color:#06c; font-weight:bold;"">world</span>."
"tedy<br><br>Byl nemocný, <span style=""color:#06c; font-weight:bold;"">tedy</span> zůstal doma."	"so<br><br>He was ill, <span style=""color:#06c; font-weight:bold;"">so</span> he stayed at home."
přijít<br><br>Přijdu později, mám hodně práce.	to come<br><br>I will come later, I have a lot of work.
"například<br><br>Rád sportuje, <span style=""color:#06c; font-weight:bold;"">například</span> běhá ráno."	"for example<br><br>He likes sports, <span style=""color:#06c; font-weight:bold;"">for example</span> he runs in the morning."
"vysoký<br><br>Je to <span style=""color:#06c; font-weight:bold;"">vysoký</span> dům u parku."	"tall<br><br>It is a <span style=""color:#06c; font-weight:bold;"">tall</span> house by the park."
"země<br><br>Česká republika je krásná <span style=""color:#06c; font-weight:bold;"">země</span>."	"country<br><br>The Czech Republic is a beautiful <span style=""color:#06c; font-weight:bold;"">country</span>."
"tenhle<br><br><span style=""color:#06c; font-weight:bold;"">Tenhle</span> dort chutná nejlépe."	this one<br><br>This cake tastes the best.
"tři<br><br>Máme <span style=""color:#06c; font-weight:bold;"">tři</span> hodiny na přípravu."	"three<br><br>We have <span style=""color:#06c; font-weight:bold;"">three</span> hours to prepare."
"čas<br><br>Nemám <span style=""color:#06c; font-weight:bold;"">čas</span> na dlouhé filmy."	"time<br><br>I don’t have <span style=""color:#06c; font-weight:bold;"">time</span> for long movies."
"dělat<br><br>Co budeš <span style=""color:#06c; font-weight:bold;"">dělat</span> o víkendu?"	to do<br><br>What will you do at the weekend?
"žena<br><br>Ta <span style=""color:#06c; font-weight:bold;"">žena</span> pracuje v bance."	"woman<br><br>That <span style=""color:#06c; font-weight:bold;"">woman</span> works in a bank."
"žádný<br><br>Nemám dnes <span style=""color:#06c; font-weight:bold;"">žádný</span> plán."	no, none<br><br>I have no plan today.
"muž<br><br>Ten <span style=""color:#06c; font-weight:bold;"">muž</span> nosí modrý kabát."	"man<br><br>That <span style=""color:#06c; font-weight:bold;"">man</span> is wearing a blue coat."
případ<br><br>V tomhle případě máš pravdu.	"case<br><br>In this <span style=""color:#06c; font-weight:bold;"">case</span> you are right."
"kdo<br><br><span style=""color:#06c; font-weight:bold;"">Kdo</span> dnes vaří večeři?"	"who<br><br><span style=""color:#06c; font-weight:bold;"">Who</span> is cooking dinner today?"
"třeba<br><br>Kup si <span style=""color:#06c; font-weight:bold;"">třeba</span> ovoce místo sladkostí."	"for example<br><br>Buy, <span style=""color:#06c; font-weight:bold;"">for example</span>, fruit instead of sweets."
starý<br><br>Bydlí ve starém domě na okraji města.	"old<br><br>He lives in an <span style=""color:#06c; font-weight:bold;"">old</span> house on the edge of the city."
"hlava<br><br>Bolí mě <span style=""color:#06c; font-weight:bold;"">hlava</span> po celém dni."	"head<br><br>My <span style=""color:#06c; font-weight:bold;"">head</span> hurts after the whole day."
několik<br><br>Už jsem tam byl několikrát.	"several<br><br>I have already been there <span style=""color:#06c; font-weight:bold;"">several</span> times."
"velmi<br><br>Je <span style=""color:#06c; font-weight:bold;"">velmi</span> spokojený s novou prací."	"very<br><br>He is <span style=""color:#06c; font-weight:bold;"">very</span> satisfied with the new job."
"oko<br><br>Zavři jedno <span style=""color:#06c; font-weight:bold;"">oko</span> a usměj se."	"eye<br><br>Close one <span style=""color:#06c; font-weight:bold;"">eye</span> and smile."
"nad<br><br>Letadlo letí vysoko <span style=""color:#06c; font-weight:bold;"">nad</span> městem."	"above<br><br>The plane is flying high <span style=""color:#06c; font-weight:bold;"">above</span> the city."
"město<br><br>Praha je krásné <span style=""color:#06c; font-weight:bold;"">město</span>."	"city<br><br>Prague is a beautiful <span style=""color:#06c; font-weight:bold;"">city</span>."
"poslední<br><br>To byl <span style=""color:#06c; font-weight:bold;"">poslední</span> kousek pizzy."	"last<br><br>That was the <span style=""color:#06c; font-weight:bold;"">last</span> piece of pizza."
"cesta<br><br><span style=""color:#06c; font-weight:bold;"">Cesta</span> domů trvá půl hodiny."	"journey<br><br>The <span style=""color:#06c; font-weight:bold;"">journey</span> home takes half an hour."
"některý<br><br><span style=""color:#06c; font-weight:bold;"">Některý</span> student dnes nepřišel."	"some<br><br><span style=""color:#06c; font-weight:bold;"">Some</span> student didn’t come today."
"asi<br><br><span style=""color:#06c; font-weight:bold;"">Asi</span> přijdu pozdě na schůzku."	"probably<br><br>I will <span style=""color:#06c; font-weight:bold;"">probably</span> be late for the meeting."
"jaký<br><br><span style=""color:#06c; font-weight:bold;"">Jaký</span> film chceš dnes vidět?"	"what kind of<br><br><span style=""color:#06c; font-weight:bold;"">What kind of</span> film do you want to see today?"
"právě<br><br><span style=""color:#06c; font-weight:bold;"">Právě</span> čtu zajímavou knihu."	"just now<br><br>I am <span style=""color:#06c; font-weight:bold;"">just now</span> reading an interesting book."
"přes<br><br><span style=""color:#06c; font-weight:bold;"">Přes</span> víkend jsem hodně spal."	"over<br><br><span style=""color:#06c; font-weight:bold;"">Over</span> the weekend I slept a lot."
"dům<br><br>Ten <span style=""color:#06c; font-weight:bold;"">dům</span> má červenou střechu."	"house<br><br>That <span style=""color:#06c; font-weight:bold;"">house</span> has a red roof."
"proto<br><br>Byl unavený, <span style=""color:#06c; font-weight:bold;"">proto</span> odešel dřív."	"therefore<br><br>He was tired, <span style=""color:#06c; font-weight:bold;"">therefore</span> he left earlier."
"věc<br><br>Je to jednoduchá <span style=""color:#06c; font-weight:bold;"">věc</span>, jen to zkus."	"thing<br><br>It’s a simple <span style=""color:#06c; font-weight:bold;"">thing</span>, just try it."
"tu<br><br>Počkej <span style=""color:#06c; font-weight:bold;"">tu</span> a nikam nechoď."	here (colloquial)<br><br>Wait here and don’t go anywhere.
voda<br><br>Piju ráno teplou vodu s citronem.	"water<br><br>In the morning I drink warm <span style=""color:#06c; font-weight:bold;"">water</span> with lemon."
"společnost<br><br>Pracuje pro velkou mezinárodní <span style=""color:#06c; font-weight:bold;"">společnost</span>."	"company<br><br>He works for a large international <span style=""color:#06c; font-weight:bold;"">company</span>."
"najít<br><br>Nemůžu <span style=""color:#06c; font-weight:bold;"">najít</span> klíče od auta."	to find<br><br>I can’t find the car keys.
"nikdy<br><br><span style=""color:#06c; font-weight:bold;"">Nikdy</span> nekouřil cigarety."	"never<br><br>He has <span style=""color:#06c; font-weight:bold;"">never</span> smoked cigarettes."
"již<br><br><span style=""color:#06c; font-weight:bold;"">Již</span> jsem ten film viděl."	"already<br><br>I have <span style=""color:#06c; font-weight:bold;"">already</span> seen that film."
"brzy<br><br><span style=""color:#06c; font-weight:bold;"">Brzy</span> začne pršet, vezmi si plášť."	"soon<br><br>It will start raining <span style=""color:#06c; font-weight:bold;"">soon</span>, take your coat."
"část<br><br>Tahle <span style=""color:#06c; font-weight:bold;"">část</span> města je klidná."	"part<br><br>This <span style=""color:#06c; font-weight:bold;"">part</span> of the city is quiet."
"což<br><br><span style=""color:#06c; font-weight:bold;"">Což</span> není úplně špatný výsledek."	"which<br><br><span style=""color:#06c; font-weight:bold;"">Which</span> is not a completely bad result."
"udělat<br><br>Musím <span style=""color:#06c; font-weight:bold;"">udělat</span> domácí úkol."	to do, to make<br><br>I have to do my homework.
"vlastní<br><br>Má <span style=""color:#06c; font-weight:bold;"">vlastní</span> malou firmu."	"own<br><br>He has his <span style=""color:#06c; font-weight:bold;"">own</span> small company."
dokázat<br><br>Dokázal uběhnout deset kilometrů.	to manage, to prove<br><br>He managed to run ten kilometres.
chvíle<br><br>Počkej chvilku, hned přijdu.	"moment<br><br>Wait a <span style=""color:#06c; font-weight:bold;"">moment</span>, I’ll come right away."
"systém<br><br>Celý <span style=""color:#06c; font-weight:bold;"">systém</span> dnes nefunguje."	"system<br><br>The whole <span style=""color:#06c; font-weight:bold;"">system</span> is not working today."
"kdyby<br><br><span style=""color:#06c; font-weight:bold;"">Kdyby</span> měl čas, jel by s námi."	if (subjunctive)<br><br>If he had time, he would go with us.
hodina<br><br>Za hodinu musím být v práci.	"hour<br><br>In an <span style=""color:#06c; font-weight:bold;"">hour</span> I have to be at work."
"proč<br><br><span style=""color:#06c; font-weight:bold;"">Proč</span> se zase hádáte?"	"why<br><br><span style=""color:#06c; font-weight:bold;"">Why</span> are you arguing again?"
"stejně<br><br><span style=""color:#06c; font-weight:bold;"">Stejně</span> tam dnes nepůjdu."	"anyway<br><br>I’m not going there today <span style=""color:#06c; font-weight:bold;"">anyway</span>."
"takže<br><br>Bylo pozdě, <span style=""color:#06c; font-weight:bold;"">takže</span> jsme jeli taxíkem."	so that, so<br><br>It was late, so we took a taxi.
"často<br><br><span style=""color:#06c; font-weight:bold;"">Často</span> chodím běhat do parku."	"often<br><br>I <span style=""color:#06c; font-weight:bold;"">often</span> go running in the park."
"dnes<br><br><span style=""color:#06c; font-weight:bold;"">Dnes</span> mám volno a nic neplánuji."	"today<br><br><span style=""color:#06c; font-weight:bold;"">Today</span> I have time off and plan nothing."
"slovo<br><br>To <span style=""color:#06c; font-weight:bold;"">slovo</span> jsem ještě nikdy neslyšel."	"word<br><br>I have never heard that <span style=""color:#06c; font-weight:bold;"">word</span> before."
"tady<br><br>Sedni si <span style=""color:#06c; font-weight:bold;"">tady</span> vedle mě."	"here<br><br>Sit <span style=""color:#06c; font-weight:bold;"">here</span> next to me."
"až<br><br>Zavolej mi, <span style=""color:#06c; font-weight:bold;"">až</span> přijedeš domů."	"only when<br><br>Call me <span style=""color:#06c; font-weight:bold;"">only when</span> you arrive home."
"lze<br><br>Tady <span style=""color:#06c; font-weight:bold;"">lze</span> platit kartou."	"it is possible<br><br><span style=""color:#06c; font-weight:bold;"">It is possible</span> to pay by card here."
nechat<br><br>Nech mě chvíli v klidu.	to leave, to let<br><br>Let me be in peace for a moment.
"problém<br><br>Máme malý <span style=""color:#06c; font-weight:bold;"">problém</span> s internetem."	"problem<br><br>We have a small <span style=""color:#06c; font-weight:bold;"">problem</span> with the internet."
"někdo<br><br><span style=""color:#06c; font-weight:bold;"">Někdo</span> ti volal, když jsi spal."	"someone<br><br><span style=""color:#06c; font-weight:bold;"">Someone</span> called you while you were sleeping."
"oba<br><br><span style=""color:#06c; font-weight:bold;"">Oba</span> bráchové hrají fotbal."	"both<br><br><span style=""color:#06c; font-weight:bold;"">Both</span> brothers play football."
možný<br><br>Je možné, že přijde pozdě.	"possible<br><br>It is <span style=""color:#06c; font-weight:bold;"">possible</span> that he will come late."
"vůbec<br><br>To mě <span style=""color:#06c; font-weight:bold;"">vůbec</span> nezajímá."	"at all<br><br>That doesn’t interest me <span style=""color:#06c; font-weight:bold;"">at all</span>."
"cena<br><br><span style=""color:#06c; font-weight:bold;"">Cena</span> za lístek je dnes nižší."	"price<br><br>The <span style=""color:#06c; font-weight:bold;"">price</span> of the ticket is lower today."
"proti<br><br>Hrál <span style=""color:#06c; font-weight:bold;"">proti</span> silnějšímu soupeři."	"against<br><br>He played <span style=""color:#06c; font-weight:bold;"">against</span> a stronger opponent."
"rád<br><br><span style=""color:#06c; font-weight:bold;"">Rád</span> piju kávu bez cukru."	glad, to like<br><br>I like drinking coffee without sugar.
"stále<br><br><span style=""color:#06c; font-weight:bold;"">Stále</span> čekám na tvoji odpověď."	"still<br><br>I am <span style=""color:#06c; font-weight:bold;"">still</span> waiting for your answer."
"řada<br><br>Celá <span style=""color:#06c; font-weight:bold;"">řada</span> lidí přišla pozdě."	row, series<br><br>A whole row of people came late.
"možná<br><br><span style=""color:#06c; font-weight:bold;"">Možná</span> se uvidíme o víkendu."	"maybe<br><br><span style=""color:#06c; font-weight:bold;"">Maybe</span> we will see each other at the weekend."
škola<br><br>Děti jdou ráno do školy.	"school<br><br>The children go to <span style=""color:#06c; font-weight:bold;"">school</span> in the morning."
"pouze<br><br>Platí to <span style=""color:#06c; font-weight:bold;"">pouze</span> pro studenty."	"only<br><br>It applies <span style=""color:#06c; font-weight:bold;"">only</span> to students."
hrát<br><br>Večer hrajeme karty s rodinou.	to play<br><br>In the evening we play cards with the family.
"jestli<br><br>Nevím, <span style=""color:#06c; font-weight:bold;"">jestli</span> přijde včas."	if (whether)<br><br>I don’t know whether he will come on time.
"nikdo<br><br><span style=""color:#06c; font-weight:bold;"">Nikdo</span> nechtěl odejít první."	"no one<br><br><span style=""color:#06c; font-weight:bold;"">No one</span> wanted to leave first."
firma<br><br>Pracuju ve známé IT firmě.	"company<br><br>I work in a well-known IT <span style=""color:#06c; font-weight:bold;"">company</span>."
"mladý<br><br>Ještě je moc <span style=""color:#06c; font-weight:bold;"">mladý</span> na řízení auta."	"young<br><br>He is still too <span style=""color:#06c; font-weight:bold;"">young</span> to drive a car."
"totiž<br><br>Nemůžu přijít, <span style=""color:#06c; font-weight:bold;"">totiž</span> jsem nemocný."	you see, namely<br><br>I can’t come, you see, I am ill.
různý<br><br>Má různé zájmy a koníčky.	"different<br><br>He has <span style=""color:#06c; font-weight:bold;"">different</span> interests and hobbies."
čekat<br><br>Čekám na autobus už deset minut.	to wait<br><br>I have been waiting for the bus for ten minutes.
mluvit<br><br>Mluví pomalu, aby všichni rozuměli.	to speak<br><br>He speaks slowly so that everyone understands.
"dlouhý<br><br>Byl to <span style=""color:#06c; font-weight:bold;"">dlouhý</span> den v kanceláři."	"long<br><br>It was a <span style=""color:#06c; font-weight:bold;"">long</span> day in the office."
"kolem<br><br>Prošli jsme <span style=""color:#06c; font-weight:bold;"">kolem</span> řeky až do centra."	around<br><br>We walked along the river all the way to the centre.
váš<br><br>Jaké jsou vaše plány na léto?	your (plural)<br><br>What are your plans for the summer?
"málo<br><br>Mám <span style=""color:#06c; font-weight:bold;"">málo</span> času na odpočinek."	"little<br><br>I have <span style=""color:#06c; font-weight:bold;"">little</span> time to rest."
"jediný<br><br>Nebyl tam <span style=""color:#06c; font-weight:bold;"">jediný</span> volný stůl."	only, single<br><br>There wasn’t a single free table there.
"vrátit<br><br>Musím <span style=""color:#06c; font-weight:bold;"">vrátit</span> tu knihu do knihovny."	"to return<br><br>I have <span style=""color:#06c; font-weight:bold;"">to return</span> that book to the library."
"zase<br><br><span style=""color:#06c; font-weight:bold;"">Zase</span> jsi zapomněl klíče doma."	"again<br><br>You forgot your keys at home <span style=""color:#06c; font-weight:bold;"">again</span>."
snažit<br><br>Snažím se mluvit česky každý den.	to try<br><br>I am trying to speak Czech every day.
"konec<br><br>Blíží se <span style=""color:#06c; font-weight:bold;"">konec</span> školního roku."	"end<br><br>The <span style=""color:#06c; font-weight:bold;"">end</span> of the school year is approaching."
vypadat<br><br>Vypadáš dnes velmi spokojeně.	to look (seem)<br><br>You look very satisfied today.
koruna<br><br>Má jen pár korun v peněžence.	crown (currency)<br><br>He has only a few crowns in his wallet.
"pohled<br><br>Na první <span style=""color:#06c; font-weight:bold;"">pohled</span> to vypadá snadné."	look, view<br><br>At first glance it looks easy.
"vzít<br><br>Můžeš <span style=""color:#06c; font-weight:bold;"">vzít</span> tu tašku, prosím?"	to take<br><br>Can you take that bag, please?
"dokonce<br><br><span style=""color:#06c; font-weight:bold;"">Dokonce</span> se naučil česky za rok."	"even<br><br>He <span style=""color:#06c; font-weight:bold;"">even</span> learned Czech in a year."
patřit<br><br>Tohle kolo patří mému bratrovi.	to belong<br><br>This bike belongs to my brother.
"způsob<br><br>Najdeme lepší <span style=""color:#06c; font-weight:bold;"">způsob</span>, jak to udělat."	way, manner<br><br>We will find a better way to do it.
"hlavní<br><br><span style=""color:#06c; font-weight:bold;"">Hlavní</span> problém je nedostatek času."	"main<br><br>The <span style=""color:#06c; font-weight:bold;"">main</span> problem is a lack of time."
"zůstat<br><br>Musel <span style=""color:#06c; font-weight:bold;"">zůstat</span> doma s dětmi."	"to stay<br><br>He had <span style=""color:#06c; font-weight:bold;"">to stay</span> at home with the children."
"dveře<br><br>Zavři <span style=""color:#06c; font-weight:bold;"">dveře</span>, je tu průvan."	"door<br><br>Close the <span style=""color:#06c; font-weight:bold;"">door</span>, there is a draft here."
"možnost<br><br>Máš <span style=""color:#06c; font-weight:bold;"">možnost</span> zůstat nebo odejít."	"possibility<br><br>You have the <span style=""color:#06c; font-weight:bold;"">possibility</span> to stay or to leave."
"žít<br><br>Chce <span style=""color:#06c; font-weight:bold;"">žít</span> zdravěji než dřív."	"to live<br><br>He wants <span style=""color:#06c; font-weight:bold;"">to live</span> more healthily than before."
znát<br><br>Neznám dobře tohle město.	to know<br><br>I don’t know this city well.
"trochu<br><br>Mám dnes jen <span style=""color:#06c; font-weight:bold;"">trochu</span> času."	"a little<br><br>Today I have only <span style=""color:#06c; font-weight:bold;"">a little</span> time."
"nakonec<br><br><span style=""color:#06c; font-weight:bold;"">Nakonec</span> jsme zůstali doma."	"in the end<br><br><span style=""color:#06c; font-weight:bold;"">In the end</span> we stayed at home."
"peníze<br><br>Šetří <span style=""color:#06c; font-weight:bold;"">peníze</span> na novou dovolenou."	"money<br><br>He is saving <span style=""color:#06c; font-weight:bold;"">money</span> for a new holiday."
"taky<br><br>Byl tam on a <span style=""color:#06c; font-weight:bold;"">taky</span> jeho bratr."	"also<br><br>He was there and <span style=""color:#06c; font-weight:bold;"">also</span> his brother."
"tělo<br><br>Po tréninku mě bolí celé <span style=""color:#06c; font-weight:bold;"">tělo</span>."	"body<br><br>After training my whole <span style=""color:#06c; font-weight:bold;"">body</span> hurts."
"daleko<br><br>Bydlí <span style=""color:#06c; font-weight:bold;"">daleko</span> od centra města."	"far<br><br>He lives <span style=""color:#06c; font-weight:bold;"">far</span> from the city centre."
"situace<br><br>Tahle <span style=""color:#06c; font-weight:bold;"">situace</span> je pro mě nová."	"situation<br><br>This <span style=""color:#06c; font-weight:bold;"">situation</span> is new for me."
"stát<br><br>Česká republika je středoevropský <span style=""color:#06c; font-weight:bold;"">stát</span>."	state, country<br><br>The Czech Republic is a Central European state.
otázka<br><br>Mám na tebe jen jednu otázku.	"question<br><br>I have only one <span style=""color:#06c; font-weight:bold;"">question</span> for you."
"kniha<br><br>Tahle <span style=""color:#06c; font-weight:bold;"">kniha</span> je hodně napínavá."	"book<br><br>This <span style=""color:#06c; font-weight:bold;"">book</span> is very thrilling."
"kvůli<br><br>Přišel pozdě <span style=""color:#06c; font-weight:bold;"">kvůli</span> dopravě."	"because of<br><br>He arrived late <span style=""color:#06c; font-weight:bold;"">because of</span> traffic."
"skupina<br><br><span style=""color:#06c; font-weight:bold;"">Skupina</span> studentů čeká před školou."	"group<br><br>A <span style=""color:#06c; font-weight:bold;"">group</span> of students is waiting in front of the school."
"znovu<br><br>Zkusím to <span style=""color:#06c; font-weight:bold;"">znovu</span> a lépe."	"again<br><br>I’ll try it <span style=""color:#06c; font-weight:bold;"">again</span> and better."
"navíc<br><br>Dostal <span style=""color:#06c; font-weight:bold;"">navíc</span> jeden den volna."	in addition<br><br>He got one extra day off.
cítit<br><br>Cítím se dnes nějak unaveně.	to feel<br><br>I feel somehow tired today.
"ovšem<br><br>Můžeš přijít, <span style=""color:#06c; font-weight:bold;"">ovšem</span> musíš zavolat předem."	"of course<br><br>You can come, <span style=""color:#06c; font-weight:bold;"">of course</span>, but you must call in advance."
"ano<br><br>Řekla jasné <span style=""color:#06c; font-weight:bold;"">ano</span> na jeho otázku."	"yes<br><br>She said a clear <span style=""color:#06c; font-weight:bold;"">yes</span> to his question."
"dojít<br><br>Musíme <span style=""color:#06c; font-weight:bold;"">dojít</span> na poštu ještě dnes."	to reach, to run out<br><br>We must get to the post office today.
"pan<br><br><span style=""color:#06c; font-weight:bold;"">Pan</span> Novák dnes nepřijde."	Mr.<br><br>Mr Novak will not come today.
"otec<br><br>Můj <span style=""color:#06c; font-weight:bold;"">otec</span> rád opravuje auta."	"father<br><br>My <span style=""color:#06c; font-weight:bold;"">father</span> likes fixing cars."
"tisíc<br><br>Přišlo asi <span style=""color:#06c; font-weight:bold;"">tisíc</span> lidí na koncert."	"thousand<br><br>About a <span style=""color:#06c; font-weight:bold;"">thousand</span> people came to the concert."
"mnoho<br><br>Má <span style=""color:#06c; font-weight:bold;"">mnoho</span> zkušeností z ciziny."	many, much<br><br>He has a lot of experience from abroad.
"rodina<br><br>Moje <span style=""color:#06c; font-weight:bold;"">rodina</span> tráví víkendy na chatě."	"family<br><br>My <span style=""color:#06c; font-weight:bold;"">family</span> spends weekends at the cottage."
"ostatní<br><br><span style=""color:#06c; font-weight:bold;"">Ostatní</span> kolegové už odešli domů."	others<br><br>The other colleagues have already gone home.
"měsíc<br><br>Za <span style=""color:#06c; font-weight:bold;"">měsíc</span> začínají prázdniny."	"month<br><br>The holidays start in a <span style=""color:#06c; font-weight:bold;"">month</span>."
"čtyři<br><br>Máme doma <span style=""color:#06c; font-weight:bold;"">čtyři</span> židle."	"four<br><br>We have <span style=""color:#06c; font-weight:bold;"">four</span> chairs at home."
"především<br><br><span style=""color:#06c; font-weight:bold;"">Především</span> chci mít dostatek času."	"above all<br><br><span style=""color:#06c; font-weight:bold;"">Above all</span> I want to have enough time."
"získat<br><br>Chce <span style=""color:#06c; font-weight:bold;"">získat</span> lepší práci."	to obtain<br><br>He wants to get a better job.
"matka<br><br>Jeho <span style=""color:#06c; font-weight:bold;"">matka</span> pracuje v nemocnici."	"mother<br><br>His <span style=""color:#06c; font-weight:bold;"">mother</span> works in a hospital."
"hned<br><br>Přijdu <span style=""color:#06c; font-weight:bold;"">hned</span>, jen si obuju boty."	"immediately<br><br>I’ll come <span style=""color:#06c; font-weight:bold;"">immediately</span>, I’ll just put on my shoes."
změna<br><br>Potřebuje velkou změnu v životě.	"change<br><br>He needs a big <span style=""color:#06c; font-weight:bold;"">change</span> in his life."
"dále<br><br>Pokračujte <span style=""color:#06c; font-weight:bold;"">dále</span> rovně po ulici."	"further<br><br>Continue <span style=""color:#06c; font-weight:bold;"">further</span> straight along the street."
"během<br><br><span style=""color:#06c; font-weight:bold;"">Během</span> týdne nemám moc času."	"during<br><br><span style=""color:#06c; font-weight:bold;"">During</span> the week I don’t have much time."
"jméno<br><br>Jaké je tvoje celé <span style=""color:#06c; font-weight:bold;"">jméno</span>?"	"name<br><br>What is your full <span style=""color:#06c; font-weight:bold;"">name</span>?"
projekt<br><br>Pracuje na novém projektu v práci.	"project<br><br>He is working on a new <span style=""color:#06c; font-weight:bold;"">project</span> at work."
"pár<br><br>Mám pro tebe <span style=""color:#06c; font-weight:bold;"">pár</span> otázek."	a few, couple<br><br>I have a few questions for you.
"znamenat<br><br>Co má to slovo <span style=""color:#06c; font-weight:bold;"">znamenat</span>?"	"to mean<br><br>What is that word supposed <span style=""color:#06c; font-weight:bold;"">to mean</span>?"
"týden<br><br>Za <span style=""color:#06c; font-weight:bold;"">týden</span> jedeme na hory."	"week<br><br>In a <span style=""color:#06c; font-weight:bold;"">week</span> we are going to the mountains."
pracovat<br><br>Pracuje z domova tři dny v týdnu.	to work<br><br>He works from home three days a week.
"zde<br><br>Prosím podepište se <span style=""color:#06c; font-weight:bold;"">zde</span>."	here (formal)<br><br>Please sign here.
"dlouho<br><br>Čekali jsme <span style=""color:#06c; font-weight:bold;"">dlouho</span> na výsledky."	for a long time<br><br>We waited a long time for the results.
"auto<br><br>Jeho <span style=""color:#06c; font-weight:bold;"">auto</span> je zaparkované před domem."	"car<br><br>His <span style=""color:#06c; font-weight:bold;"">car</span> is parked in front of the house."
"snad<br><br><span style=""color:#06c; font-weight:bold;"">Snad</span> zítra nebude pršet."	"hopefully<br><br><span style=""color:#06c; font-weight:bold;"">Hopefully</span> it won’t rain tomorrow."
"tvář<br><br>Měl vážnou <span style=""color:#06c; font-weight:bold;"">tvář</span> během rozhovoru."	"face<br><br>He had a serious <span style=""color:#06c; font-weight:bold;"">face</span> during the conversation."
"zeptat<br><br>Chci se <span style=""color:#06c; font-weight:bold;"">zeptat</span> na jednu věc."	"to ask<br><br>I want <span style=""color:#06c; font-weight:bold;"">to ask</span> about one thing."
"výsledek<br><br><span style=""color:#06c; font-weight:bold;"">Výsledek</span> zkoušky byl lepší než čekal."	"result<br><br>The exam <span style=""color:#06c; font-weight:bold;"">result</span> was better than he expected."
"díky<br><br><span style=""color:#06c; font-weight:bold;"">Díky</span> tobě jsme to stihli včas."	"thanks to<br><br><span style=""color:#06c; font-weight:bold;"">Thanks to</span> you we managed it on time."
"někdy<br><br><span style=""color:#06c; font-weight:bold;"">Někdy</span> chodím běhat ráno."	"sometimes<br><br><span style=""color:#06c; font-weight:bold;"">Sometimes</span> I go running in the morning."
"většina<br><br><span style=""color:#06c; font-weight:bold;"">Většina</span> lidí souhlasila s plánem."	"majority<br><br>The <span style=""color:#06c; font-weight:bold;"">majority</span> of people agreed with the plan."
"úplně<br><br>Jsem po práci <span style=""color:#06c; font-weight:bold;"">úplně</span> vyčerpaný."	"completely<br><br>I am <span style=""color:#06c; font-weight:bold;"">completely</span> exhausted after work."
"příliš<br><br>Je to <span style=""color:#06c; font-weight:bold;"">příliš</span> drahé pro studenty."	too (much)<br><br>It is too expensive for students.
"slyšet<br><br>Nemůžu tě dobře <span style=""color:#06c; font-weight:bold;"">slyšet</span>."	to hear<br><br>I can’t hear you well.
"rychle<br><br>Musíme <span style=""color:#06c; font-weight:bold;"">rychle</span> dokončit úkol."	"quickly<br><br>We have to finish the task <span style=""color:#06c; font-weight:bold;"">quickly</span>."
"nyní<br><br><span style=""color:#06c; font-weight:bold;"">Nyní</span> můžete klidně odejít."	now (formal)<br><br>You may leave now.
"li<br><br>Nevíš-<span style=""color:#06c; font-weight:bold;"">li</span> kudy, zeptej se."	if (in constructions)<br><br>If you don’t know which way, ask.
"pět<br><br>Potřebuju <span style=""color:#06c; font-weight:bold;"">pět</span> minut pauzu."	"five<br><br>I need a <span style=""color:#06c; font-weight:bold;"">five</span>-minute break."
"téměř<br><br>Je <span style=""color:#06c; font-weight:bold;"">téměř</span> deset hodin večer."	"almost<br><br>It is <span style=""color:#06c; font-weight:bold;"">almost</span> ten o’clock in the evening."
"podívat<br><br>Pojďme se <span style=""color:#06c; font-weight:bold;"">podívat</span> na film."	to look at<br><br>Let’s go watch a movie.
"co<br><br>Nevím, <span style=""color:#06c; font-weight:bold;"">co</span> si o tom myslet."	"what<br><br>I don’t know <span style=""color:#06c; font-weight:bold;"">what</span> to think about it."
"známý<br><br>Je to <span style=""color:#06c; font-weight:bold;"">známý</span> zpěvák."	known, acquaintance<br><br>He is a well-known singer.
"ještě<br><br>Pořád <span style=""color:#06c; font-weight:bold;"">ještě</span> nemám hotový úkol."	still, yet<br><br>I still don’t have the homework finished.
noc<br><br>V noci je tu úplné ticho.	"night<br><br>At <span style=""color:#06c; font-weight:bold;"">night</span> it is completely quiet here."
síla<br><br>Nemám sílu pokračovat dál.	"strength<br><br>I don’t have the <span style=""color:#06c; font-weight:bold;"">strength</span> to continue."
"vztah<br><br>Mají dobrý <span style=""color:#06c; font-weight:bold;"">vztah</span> se sousedy."	"relationship<br><br>They have a good <span style=""color:#06c; font-weight:bold;"">relationship</span> with their neighbours."
noha<br><br>Zranil si nohu při fotbale.	"leg<br><br>He injured his <span style=""color:#06c; font-weight:bold;"">leg</span> while playing football."
"dost<br><br>Mám <span style=""color:#06c; font-weight:bold;"">dost</span> práce na celý týden."	"enough<br><br>I have <span style=""color:#06c; font-weight:bold;"">enough</span> work for the whole week."
"spíš<br><br><span style=""color:#06c; font-weight:bold;"">Spíš</span> zůstanu doma než půjdu do kina."	"rather<br><br>I’d <span style=""color:#06c; font-weight:bold;"">rather</span> stay at home than go to the cinema."
"program<br><br>Večerní <span style=""color:#06c; font-weight:bold;"">program</span> je už plný."	"program<br><br>The evening <span style=""color:#06c; font-weight:bold;"">program</span> is already full."
"rozhodnout<br><br>Musíš se rychle <span style=""color:#06c; font-weight:bold;"">rozhodnout</span>."	"to decide<br><br>You have <span style=""color:#06c; font-weight:bold;"">to decide</span> quickly."
"přece<br><br>Vždyť to <span style=""color:#06c; font-weight:bold;"">přece</span> víš."	"after all<br><br>You know that <span style=""color:#06c; font-weight:bold;"">after all</span>."
"vlastně<br><br><span style=""color:#06c; font-weight:bold;"">Vlastně</span> se mi ten nápad líbí."	"actually<br><br><span style=""color:#06c; font-weight:bold;"">Actually</span> I like that idea."
"hlas<br><br>Jeho <span style=""color:#06c; font-weight:bold;"">hlas</span> zněl unaveně."	"voice<br><br>His <span style=""color:#06c; font-weight:bold;"">voice</span> sounded tired."
"jenom<br><br>Chtěl jsem <span style=""color:#06c; font-weight:bold;"">jenom</span> pomoct."	only<br><br>I just wanted to help.
"důvod<br><br>Nemám <span style=""color:#06c; font-weight:bold;"">důvod</span> ti nevěřit."	"reason<br><br>I have no <span style=""color:#06c; font-weight:bold;"">reason</span> not to believe you."
"hra<br><br>Tahle <span style=""color:#06c; font-weight:bold;"">hra</span> je hodně návyková."	"game<br><br>This <span style=""color:#06c; font-weight:bold;"">game</span> is very addictive."
"film<br><br>Ten <span style=""color:#06c; font-weight:bold;"">film</span> jsem viděl už dvakrát."	"film<br><br>I’ve already seen that <span style=""color:#06c; font-weight:bold;"">film</span> twice."
"opravdu<br><br>Je to <span style=""color:#06c; font-weight:bold;"">opravdu</span> dobrá restaurace."	"really<br><br>It is a <span style=""color:#06c; font-weight:bold;"">really</span> good restaurant."
minuta<br><br>Za minutu začíná porada.	"minute<br><br>The meeting starts in a <span style=""color:#06c; font-weight:bold;"">minute</span>."
"pořád<br><br><span style=""color:#06c; font-weight:bold;"">Pořád</span> myslím na tu dovolenou."	still, always<br><br>I still think about that holiday.
"samozřejmě<br><br><span style=""color:#06c; font-weight:bold;"">Samozřejmě</span> ti s tím pomůžu."	"of course<br><br><span style=""color:#06c; font-weight:bold;"">Of course</span> I’ll help you with that."
"nejen<br><br>Je chytrý, <span style=""color:#06c; font-weight:bold;"">nejen</span> pilný."	"not only<br><br>He is smart, <span style=""color:#06c; font-weight:bold;"">not only</span> hard-working."
informace<br><br>Potřebuju více informací o kurzu.	"information<br><br>I need more <span style=""color:#06c; font-weight:bold;"">information</span> about the course."
objevit<br><br>Objevili nový způsob léčby.	to discover<br><br>They discovered a new method of treatment.
prostor<br><br>V pokoji je málo prostoru.	"space<br><br>There is little <span style=""color:#06c; font-weight:bold;"">space</span> in the room."
"přitom<br><br>Smál se a <span style=""color:#06c; font-weight:bold;"">přitom</span> kroutil hlavou."	"at the same time<br><br>He was laughing and <span style=""color:#06c; font-weight:bold;"">at the same time</span> shaking his head."
pravda<br><br>Řekni mi pravdu, prosím.	"truth<br><br>Tell me the <span style=""color:#06c; font-weight:bold;"">truth</span>, please."
"ukázat<br><br>Můžeš mi <span style=""color:#06c; font-weight:bold;"">ukázat</span> cestu?"	to show<br><br>Can you show me the way?
"služba<br><br><span style=""color:#06c; font-weight:bold;"">Služba</span> v hotelu byla výborná."	"service<br><br>The <span style=""color:#06c; font-weight:bold;"">service</span> in the hotel was excellent."
existovat<br><br>Takové místo opravdu existuje.	to exist<br><br>Such a place really exists.
"vždy<br><br><span style=""color:#06c; font-weight:bold;"">Vždy</span> přijdeš pozdě na schůzky."	"always<br><br>You <span style=""color:#06c; font-weight:bold;"">always</span> come late to meetings."
"uvést<br><br>Musíš <span style=""color:#06c; font-weight:bold;"">uvést</span> své jméno a adresu."	to state, to list<br><br>You must state your name and address.
"evropský<br><br>Studuje <span style=""color:#06c; font-weight:bold;"">evropský</span> právní systém."	"European<br><br>He studies the <span style=""color:#06c; font-weight:bold;"">European</span> legal system."
sedět<br><br>Seděl u okna a četl si.	to sit<br><br>He sat by the window and read.
"zcela<br><br>Byl <span style=""color:#06c; font-weight:bold;"">zcela</span> překvapen výsledkem."	"completely<br><br>He was <span style=""color:#06c; font-weight:bold;"">completely</span> surprised by the result."
"přímo<br><br>Bydlí <span style=""color:#06c; font-weight:bold;"">přímo</span> v centru města."	"directly<br><br>He lives <span style=""color:#06c; font-weight:bold;"">directly</span> in the city centre."
"druh<br><br>Jaký <span style=""color:#06c; font-weight:bold;"">druh</span> hudby posloucháš?"	kind, type<br><br>What kind of music do you listen to?
"století<br><br>Román se odehrává v 19. <span style=""color:#06c; font-weight:bold;"">století</span>."	"century<br><br>The novel takes place in the 19th <span style=""color:#06c; font-weight:bold;"">century</span>."
"jistý<br><br>Jsem si <span style=""color:#06c; font-weight:bold;"">jistý</span>, že to zvládneš."	"certain<br><br>I am <span style=""color:#06c; font-weight:bold;"">certain</span> that you can manage it."
"základní<br><br>To jsou <span style=""color:#06c; font-weight:bold;"">základní</span> pravidla hry."	"basic<br><br>These are the <span style=""color:#06c; font-weight:bold;"">basic</span> rules of the game."
stačit<br><br>Stačí ti jedna vstupenka?	to be enough<br><br>Is one ticket enough for you?
"kromě<br><br><span style=""color:#06c; font-weight:bold;"">Kromě</span> práce se věnuje i sportu."	"besides<br><br><span style=""color:#06c; font-weight:bold;"">Besides</span> work he also does sports."
"pomoci<br><br>Můžeš mi s tím prosím <span style=""color:#06c; font-weight:bold;"">pomoci</span>?"	to help<br><br>Can you please help me with this?
"potom<br><br>Nejdřív uklidím a <span style=""color:#06c; font-weight:bold;"">potom</span> půjdu ven."	"then<br><br>First I’ll clean and <span style=""color:#06c; font-weight:bold;"">then</span> I’ll go out."
"jinak<br><br>Pospěš si, <span style=""color:#06c; font-weight:bold;"">jinak</span> přijdeme pozdě."	"otherwise<br><br>Hurry up, <span style=""color:#06c; font-weight:bold;"">otherwise</span> we will be late."
"bílý<br><br>Má <span style=""color:#06c; font-weight:bold;"">bílý</span> hrnek na kávu."	"white<br><br>He has a <span style=""color:#06c; font-weight:bold;"">white</span> mug for coffee."
"tehdy<br><br><span style=""color:#06c; font-weight:bold;"">Tehdy</span> jsem bydlel v Brně."	"at that time<br><br><span style=""color:#06c; font-weight:bold;"">At that time</span> I lived in Brno."
"plný<br><br>Vlak byl <span style=""color:#06c; font-weight:bold;"">plný</span> lidí."	"full<br><br>The train was <span style=""color:#06c; font-weight:bold;"">full</span> of people."
"špatný<br><br>Mám dnes <span style=""color:#06c; font-weight:bold;"">špatný</span> den."	"bad<br><br>I am having a <span style=""color:#06c; font-weight:bold;"">bad</span> day today."
"vždycky<br><br><span style=""color:#06c; font-weight:bold;"">Vždycky</span> si ráno dám kávu."	"always<br><br>I <span style=""color:#06c; font-weight:bold;"">always</span> have coffee in the morning."
procento<br><br>Sleva je deset procent.	"percent<br><br>The discount is ten <span style=""color:#06c; font-weight:bold;"">percent</span>."
"podobný<br><br>Máme <span style=""color:#06c; font-weight:bold;"">podobný</span> vkus na filmy."	"similar<br><br>We have <span style=""color:#06c; font-weight:bold;"">similar</span> taste in films."
chodit<br><br>Chodí běhat každé ráno.	to go regularly<br><br>He goes running every morning.
zdát<br><br>Zdá se mi to příliš složité.	to seem<br><br>It seems too complicated to me.
ulice<br><br>Bydlí v klidné ulici.	"street<br><br>He lives in a quiet <span style=""color:#06c; font-weight:bold;"">street</span>."
zákon<br><br>Podle zákona musí zaplatit pokutu.	"law<br><br>According to the <span style=""color:#06c; font-weight:bold;"">law</span> he must pay a fine."
"typ<br><br>Jaký <span style=""color:#06c; font-weight:bold;"">typ</span> hudby máš rád?"	"type<br><br>What <span style=""color:#06c; font-weight:bold;"">type</span> of music do you like?"
hodnota<br><br>Cena má pro mě jinou hodnotu.	"value<br><br>The price has a different <span style=""color:#06c; font-weight:bold;"">value</span> for me."
"pocit<br><br>Mám z toho dobrý <span style=""color:#06c; font-weight:bold;"">pocit</span>."	"feeling<br><br>I have a good <span style=""color:#06c; font-weight:bold;"">feeling</span> about it."
"stav<br><br>Jeho zdravotní <span style=""color:#06c; font-weight:bold;"">stav</span> se zlepšil."	state, condition<br><br>His health condition has improved.
"černý<br><br>Nosí jen <span style=""color:#06c; font-weight:bold;"">černý</span> kabát."	"black<br><br>He wears only a <span style=""color:#06c; font-weight:bold;"">black</span> coat."
"okno<br><br>Otevři <span style=""color:#06c; font-weight:bold;"">okno</span>, je tu horko."	"window<br><br>Open the <span style=""color:#06c; font-weight:bold;"">window</span>, it’s hot in here."
dávat<br><br>Každý večer dává knihu na stůl.	to give, to put<br><br>Every evening he puts the book on the table.
věřit<br><br>Věřím, že to dobře dopadne.	to believe<br><br>I believe it will turn out well.
"počet<br><br><span style=""color:#06c; font-weight:bold;"">Počet</span> účastníků roste."	"number<br><br>The <span style=""color:#06c; font-weight:bold;"">number</span> of participants is growing."
"právo<br><br>Máš <span style=""color:#06c; font-weight:bold;"">právo</span> na svůj názor."	law, right<br><br>You have the right to your opinion.
"směr<br><br>Změnili <span style=""color:#06c; font-weight:bold;"">směr</span> cesty."	"direction<br><br>They changed the <span style=""color:#06c; font-weight:bold;"">direction</span> of the trip."
"zatím<br><br><span style=""color:#06c; font-weight:bold;"">Zatím</span> je všechno v pořádku."	"so far<br><br><span style=""color:#06c; font-weight:bold;"">So far</span> everything is fine."
"zatímco<br><br>On vaří, <span style=""color:#06c; font-weight:bold;"">zatímco</span> ona čte."	"while<br><br>He cooks <span style=""color:#06c; font-weight:bold;"">while</span> she reads."
"otevřít<br><br>Můžeš <span style=""color:#06c; font-weight:bold;"">otevřít</span> ty dveře?"	to open<br><br>Can you open that door?
platit<br><br>V obchodě platím kartou.	to pay<br><br>I pay by card in the shop.
"spolu<br><br><span style=""color:#06c; font-weight:bold;"">Spolu</span> často jezdí na výlety."	"together<br><br>They often go on trips <span style=""color:#06c; font-weight:bold;"">together</span>."
smrt<br><br>Mluvit o smrti není snadné.	"death<br><br>Talking about <span style=""color:#06c; font-weight:bold;"">death</span> is not easy."
"stůl<br><br>Položil knihu na <span style=""color:#06c; font-weight:bold;"">stůl</span>."	"table<br><br>He put the book on the <span style=""color:#06c; font-weight:bold;"">table</span>."
"opět<br><br><span style=""color:#06c; font-weight:bold;"">Opět</span> jsme se setkali v Praze."	"again<br><br>We met <span style=""color:#06c; font-weight:bold;"">again</span> in Prague."
"bod<br><br>Získal další <span style=""color:#06c; font-weight:bold;"">bod</span> v soutěži."	"point<br><br>He gained another <span style=""color:#06c; font-weight:bold;"">point</span> in the competition."
"tým<br><br><span style=""color:#06c; font-weight:bold;"">Tým</span> vyhrál důležitý zápas."	"team<br><br>The <span style=""color:#06c; font-weight:bold;"">team</span> won an important match."
"zájem<br><br>Mám velký <span style=""color:#06c; font-weight:bold;"">zájem</span> o jazyky."	"interest<br><br>I have a great <span style=""color:#06c; font-weight:bold;"">interest</span> in languages."
"vláda<br><br><span style=""color:#06c; font-weight:bold;"">Vláda</span> schválila nový zákon."	"government<br><br>The <span style=""color:#06c; font-weight:bold;"">government</span> approved a new law."
"silný<br><br>Je fyzicky velmi <span style=""color:#06c; font-weight:bold;"">silný</span>."	"strong<br><br>He is physically very <span style=""color:#06c; font-weight:bold;"">strong</span>."
"prostě<br><br><span style=""color:#06c; font-weight:bold;"">Prostě</span> to udělej a neřeš to."	simply<br><br>Just do it and don’t overthink it.
"přesně<br><br>Přišel <span style=""color:#06c; font-weight:bold;"">přesně</span> včas."	"exactly<br><br>He arrived <span style=""color:#06c; font-weight:bold;"">exactly</span> on time."
trh<br><br>Na trhu prodávají čerstvé ovoce.	"market<br><br>They sell fresh fruit at the <span style=""color:#06c; font-weight:bold;"">market</span>."
"hlavně<br><br><span style=""color:#06c; font-weight:bold;"">Hlavně</span> buď opatrný."	"mainly<br><br><span style=""color:#06c; font-weight:bold;"">Mainly</span>, be careful."
kraj<br><br>Bydlí v horském kraji.	"region<br><br>He lives in a mountain <span style=""color:#06c; font-weight:bold;"">region</span>."
"jednotlivý<br><br>Řešíme každý <span style=""color:#06c; font-weight:bold;"">jednotlivý</span> problém zvlášť."	single, individual<br><br>We solve each individual problem separately.
"současný<br><br>Je <span style=""color:#06c; font-weight:bold;"">současný</span> ředitel firmy."	"current<br><br>He is the <span style=""color:#06c; font-weight:bold;"">current</span> director of the company."
"jednat<br><br>Musíme <span style=""color:#06c; font-weight:bold;"">jednat</span> rychle."	to act, to negotiate<br><br>We have to act quickly.
"světlo<br><br>Rozsviť <span style=""color:#06c; font-weight:bold;"">světlo</span> v pokoji."	"light<br><br>Turn on the <span style=""color:#06c; font-weight:bold;"">light</span> in the room."
"podmínka<br><br>To je <span style=""color:#06c; font-weight:bold;"">podmínka</span> smlouvy."	"condition<br><br>That is a <span style=""color:#06c; font-weight:bold;"">condition</span> of the contract."
"zjistit<br><br>Musíme <span style=""color:#06c; font-weight:bold;"">zjistit</span>, kde je chyba."	to find out<br><br>We must find out where the mistake is.
"lidský<br><br>Je to velmi <span style=""color:#06c; font-weight:bold;"">lidský</span> přístup."	"human<br><br>It is a very <span style=""color:#06c; font-weight:bold;"">human</span> approach."
"tvůj<br><br>Jaký je <span style=""color:#06c; font-weight:bold;"">tvůj</span> plán na víkend?"	your (singular)<br><br>What is your plan for the weekend?
"zda<br><br>Nevím, <span style=""color:#06c; font-weight:bold;"">zda</span> přijde dnes."	"whether<br><br>I don’t know <span style=""color:#06c; font-weight:bold;"">whether</span> he will come today."
"zápas<br><br>Zítra se hraje důležitý <span style=""color:#06c; font-weight:bold;"">zápas</span>."	"match<br><br>An important <span style=""color:#06c; font-weight:bold;"">match</span> is played tomorrow."
"zejména<br><br>To platí <span style=""color:#06c; font-weight:bold;"">zejména</span> pro děti."	"especially<br><br>That applies <span style=""color:#06c; font-weight:bold;"">especially</span> to children."
psát<br><br>Každý den píše krátký deník.	to write<br><br>He writes a short diary every day.
"těžký<br><br>Ten batoh je velmi <span style=""color:#06c; font-weight:bold;"">těžký</span>."	heavy, difficult<br><br>That backpack is very heavy.
"deset<br><br>Má <span style=""color:#06c; font-weight:bold;"">deset</span> nových e-mailů."	"ten<br><br>He has <span style=""color:#06c; font-weight:bold;"">ten</span> new emails."
"změnit<br><br>Chci <span style=""color:#06c; font-weight:bold;"">změnit</span> svůj životní styl."	"to change<br><br>I want <span style=""color:#06c; font-weight:bold;"">to change</span> my lifestyle."
"i<br><br>Já <span style=""color:#06c; font-weight:bold;"">i</span> on máme stejný problém."	too, even<br><br>Both he and I have the same problem.
"pokračovat<br><br>Můžeme <span style=""color:#06c; font-weight:bold;"">pokračovat</span> zítra."	to continue<br><br>We can continue tomorrow.
"no<br><br><span style=""color:#06c; font-weight:bold;"">No</span>, uvidíme, jak to dopadne."	well (discourse)<br><br>Well, we’ll see how it turns out.
jet<br><br>Zítra jedu vlakem do Brna.	to go (by vehicle)<br><br>Tomorrow I’m going to Brno by train.
"prostředí<br><br>Pracuje v mezinárodním <span style=""color:#06c; font-weight:bold;"">prostředí</span>."	"environment<br><br>He works in an international <span style=""color:#06c; font-weight:bold;"">environment</span>."
držet<br><br>Drž dveře, prosím.	to hold<br><br>Hold the door, please.
umět<br><br>Neumím dobře zpívat.	to know how<br><br>I don’t know how to sing well.
válka<br><br>Film se odehrává během války.	"war<br><br>The film takes place during the <span style=""color:#06c; font-weight:bold;"">war</span>."
"nízký<br><br>Má <span style=""color:#06c; font-weight:bold;"">nízký</span> stůl v obýváku."	"low<br><br>He has a <span style=""color:#06c; font-weight:bold;"">low</span> table in the living room."
hledat<br><br>Hledám nové bydlení.	to search<br><br>I am looking for new accommodation.
"cíl<br><br>Můj <span style=""color:#06c; font-weight:bold;"">cíl</span> je mluvit plynně česky."	"goal<br><br>My <span style=""color:#06c; font-weight:bold;"">goal</span> is to speak Czech fluently."
"zároveň<br><br>Pracuje a <span style=""color:#06c; font-weight:bold;"">zároveň</span> studuje."	"at the same time<br><br>He works and studies <span style=""color:#06c; font-weight:bold;"">at the same time</span>."
představovat<br><br>Ten dům představuje jejich styl.	to represent<br><br>That house represents their style.
dívat<br><br>Dívá se z okna na ulici.	to look<br><br>He is looking out of the window at the street.
"určitý<br><br>Mám k tomu <span style=""color:#06c; font-weight:bold;"">určitý</span> důvod."	"certain<br><br>I have a <span style=""color:#06c; font-weight:bold;"">certain</span> reason for that."
"určitě<br><br><span style=""color:#06c; font-weight:bold;"">Určitě</span> přijdu včas."	"certainly<br><br>I will <span style=""color:#06c; font-weight:bold;"">certainly</span> come on time."
"naopak<br><br>Myslel jsem si <span style=""color:#06c; font-weight:bold;"">naopak</span> opak."	on the contrary<br><br>I actually thought the opposite.
skončit<br><br>Práce skončí v pět hodin.	to finish<br><br>Work finishes at five o’clock.
"více<br><br>Potřebuji <span style=""color:#06c; font-weight:bold;"">více</span> informací."	"more<br><br>I need <span style=""color:#06c; font-weight:bold;"">more</span> information."
"pokoj<br><br>Tvůj <span style=""color:#06c; font-weight:bold;"">pokoj</span> je moc hezký."	"room<br><br>Your <span style=""color:#06c; font-weight:bold;"">room</span> is very nice."
"jednou<br><br><span style=""color:#06c; font-weight:bold;"">Jednou</span> bych chtěl žít u moře."	once<br><br>One day I’d like to live by the sea.
"rodič<br><br>Každý <span style=""color:#06c; font-weight:bold;"">rodič</span> se bojí o své dítě."	"parent<br><br>Every <span style=""color:#06c; font-weight:bold;"">parent</span> fears for their child."
"vedle<br><br>Bydlí <span style=""color:#06c; font-weight:bold;"">vedle</span> školy."	"next to<br><br>He lives <span style=""color:#06c; font-weight:bold;"">next to</span> the school."
"jasný<br><br>Je to <span style=""color:#06c; font-weight:bold;"">jasný</span> signál změny."	"clear<br><br>It is a <span style=""color:#06c; font-weight:bold;"">clear</span> signal of change."
používat<br><br>Používá mobil i při práci.	to use<br><br>He uses his mobile even at work.
"osoba<br><br>Každá <span style=""color:#06c; font-weight:bold;"">osoba</span> musí podepsat smlouvu."	"person<br><br>Each <span style=""color:#06c; font-weight:bold;"">person</span> must sign the contract."
"řešení<br><br>Musíme najít jiné <span style=""color:#06c; font-weight:bold;"">řešení</span>."	"solution<br><br>We must find another <span style=""color:#06c; font-weight:bold;"">solution</span>."
"barva<br><br>Jaká je tvoje oblíbená <span style=""color:#06c; font-weight:bold;"">barva</span>?"	"colour<br><br>What is your favourite <span style=""color:#06c; font-weight:bold;"">colour</span>?"
kolo<br><br>Ještě neumí jezdit na kole.	bike, wheel<br><br>He doesn’t know how to ride a bike yet.
začínat<br><br>Film začíná v osm večer.	to begin<br><br>The film begins at eight in the evening.
považovat<br><br>Považuju ho za dobrého člověka.	to consider<br><br>I consider him a good person.
"jenže<br><br>Chtěl jít ven, <span style=""color:#06c; font-weight:bold;"">jenže</span> prší."	but (however)<br><br>He wanted to go out, but it’s raining.
"funkce<br><br>Tato <span style=""color:#06c; font-weight:bold;"">funkce</span> není dostupná."	"function<br><br>This <span style=""color:#06c; font-weight:bold;"">function</span> is not available."
"stavba<br><br><span style=""color:#06c; font-weight:bold;"">Stavba</span> nového domu trvá rok."	building, construction<br><br>The construction of the new house takes a year.
"základ<br><br>Dobrý spánek je <span style=""color:#06c; font-weight:bold;"">základ</span> zdraví."	"basis<br><br>Good sleep is the <span style=""color:#06c; font-weight:bold;"">basis</span> of health."
podařit<br><br>Podařilo se mu složit zkoušku.	to succeed<br><br>He managed to pass the exam.
působit<br><br>Lék působí rychle.	to act, to affect<br><br>The medicine acts quickly.
"smysl<br><br>To nedává žádný <span style=""color:#06c; font-weight:bold;"">smysl</span>."	"sense<br><br>That doesn’t make any <span style=""color:#06c; font-weight:bold;"">sense</span>."
"číslo<br><br>Jaké je tvoje telefonní <span style=""color:#06c; font-weight:bold;"">číslo</span>?"	"number<br><br>What is your phone <span style=""color:#06c; font-weight:bold;"">number</span>?"
skutečnost<br><br>Ve skutečnosti je to jinak.	reality, fact<br><br>In reality it is different.
role<br><br>V té hře má hlavní roli.	"role<br><br>He has the main <span style=""color:#06c; font-weight:bold;"">role</span> in that play."
"sice<br><br>Je to těžké, <span style=""color:#06c; font-weight:bold;"">sice</span> zajímavé."	"although<br><br>It is hard, <span style=""color:#06c; font-weight:bold;"">although</span> interesting."
metr<br><br>Pokoj má asi čtyři metry na délku.	metre<br><br>The room is about four metres long.
"potřeba<br><br>Je <span style=""color:#06c; font-weight:bold;"">potřeba</span> více času na přípravu."	need<br><br>More time is needed for preparation.
"rozdíl<br><br>Mezi nimi je velký věkový <span style=""color:#06c; font-weight:bold;"">rozdíl</span>."	"difference<br><br>There is a big age <span style=""color:#06c; font-weight:bold;"">difference</span> between them."
zpráva<br><br>Dostal krátkou zprávu od kamaráda.	message, report<br><br>He got a short message from a friend.
"představit<br><br>Chci ti <span style=""color:#06c; font-weight:bold;"">představit</span> svého bratra."	to introduce, to imagine<br><br>I want to introduce my brother to you.
"odpovědět<br><br>Nezapomeň <span style=""color:#06c; font-weight:bold;"">odpovědět</span> na ten e‑mail."	"to answer<br><br>Don’t forget <span style=""color:#06c; font-weight:bold;"">to answer</span> that email."
"zdroj<br><br>Musíme najít <span style=""color:#06c; font-weight:bold;"">zdroj</span> problému."	"source<br><br>We must find the <span style=""color:#06c; font-weight:bold;"">source</span> of the problem."
nabízet<br><br>Firma nabízí nový kurz angličtiny.	to offer<br><br>The company offers a new English course.
"domácí<br><br>Má rád <span style=""color:#06c; font-weight:bold;"">domácí</span> jídlo."	home, domestic<br><br>He likes home-cooked food.
"energie<br><br>Po kávě mám víc <span style=""color:#06c; font-weight:bold;"">energie</span>."	"energy<br><br>After coffee I have more <span style=""color:#06c; font-weight:bold;"">energy</span>."
"krok<br><br>Udělali jsme první <span style=""color:#06c; font-weight:bold;"">krok</span> k cíli."	"step<br><br>We have made the first <span style=""color:#06c; font-weight:bold;"">step</span> towards the goal."
vyjít<br><br>Snad to tentokrát dobře vyjde.	to go out, to work out<br><br>Hopefully it will work out well this time.
ležet<br><br>Kniha leží na stole.	to lie (be lying)<br><br>The book is lying on the table.
"sociální<br><br>Pracuje v <span style=""color:#06c; font-weight:bold;"">sociální</span> službě."	"social<br><br>He works in <span style=""color:#06c; font-weight:bold;"">social</span> services."
"prý<br><br><span style=""color:#06c; font-weight:bold;"">Prý</span> zítra přijde sníh."	reportedly<br><br>Apparently snow will come tomorrow.
brát<br><br>Bere léky každý den.	to take<br><br>He takes medicine every day.
třetí<br><br>Bydlí ve třetím patře.	"third<br><br>He lives on the <span style=""color:#06c; font-weight:bold;"">third</span> floor."
"doma<br><br>Dnes zůstanu <span style=""color:#06c; font-weight:bold;"">doma</span>."	"at home<br><br>Today I will stay <span style=""color:#06c; font-weight:bold;"">at home</span>."
"státní<br><br>Pracuje ve <span style=""color:#06c; font-weight:bold;"">státní</span> správě."	state (adj.)<br><br>He works in the state administration.
"americký<br><br>Sleduje <span style=""color:#06c; font-weight:bold;"">americký</span> film v televizi."	"American<br><br>He is watching an <span style=""color:#06c; font-weight:bold;"">American</span> movie on TV."
centrum<br><br>Bydlí blízko centra města.	"centre<br><br>He lives near the city <span style=""color:#06c; font-weight:bold;"">centre</span>."
sledovat<br><br>Sleduje seriál každý týden.	to watch, to follow<br><br>He watches the series every week.
"paní<br><br>Ta <span style=""color:#06c; font-weight:bold;"">paní</span> pracuje na poště."	Mrs., lady<br><br>That lady works at the post office.
"připravit<br><br>Musíme <span style=""color:#06c; font-weight:bold;"">připravit</span> večeři pro hosty."	to prepare<br><br>We must prepare dinner for the guests.
člen<br><br>Je členem sportovního klubu.	"member<br><br>He is a <span style=""color:#06c; font-weight:bold;"">member</span> of a sports club."
"vhodný<br><br>To není <span style=""color:#06c; font-weight:bold;"">vhodný</span> dárek pro dítě."	"suitable<br><br>That is not a <span style=""color:#06c; font-weight:bold;"">suitable</span> gift for a child."
"akce<br><br>V sobotu je velká kulturní <span style=""color:#06c; font-weight:bold;"">akce</span>."	event, action<br><br>On Saturday there is a big cultural event.
"přesto<br><br>Byl unavený, <span style=""color:#06c; font-weight:bold;"">přesto</span> šel běhat."	"nevertheless<br><br>He was tired, <span style=""color:#06c; font-weight:bold;"">nevertheless</span> he went running."
"kam<br><br><span style=""color:#06c; font-weight:bold;"">Kam</span> zítra pojedeš na výlet?"	where to<br><br>Where will you go for a trip tomorrow?
"krásný<br><br>Dnes byl <span style=""color:#06c; font-weight:bold;"">krásný</span> slunečný den."	"beautiful<br><br>Today was a <span style=""color:#06c; font-weight:bold;"">beautiful</span> sunny day."
"obraz<br><br>Na stěně visí starý <span style=""color:#06c; font-weight:bold;"">obraz</span>."	"picture<br><br>An old <span style=""color:#06c; font-weight:bold;"">picture</span> hangs on the wall."
forma<br><br>Vyplň prosím tuto formu.	"form<br><br>Please fill in this <span style=""color:#06c; font-weight:bold;"">form</span>."
"období<br><br>To bylo náročné <span style=""color:#06c; font-weight:bold;"">období</span> v práci."	"period<br><br>It was a demanding <span style=""color:#06c; font-weight:bold;"">period</span> at work."
"byt<br><br>Koupili si nový <span style=""color:#06c; font-weight:bold;"">byt</span> v centru."	"flat<br><br>They bought a new <span style=""color:#06c; font-weight:bold;"">flat</span> in the centre."
"mnohem<br><br>Cítím se <span style=""color:#06c; font-weight:bold;"">mnohem</span> lépe než včera."	"much<br><br>I feel <span style=""color:#06c; font-weight:bold;"">much</span> better than yesterday."
"činnost<br><br>Volnočasová <span style=""color:#06c; font-weight:bold;"">činnost</span> je pro děti důležitá."	"activity<br><br>Leisure <span style=""color:#06c; font-weight:bold;"">activity</span> is important for children."
"obec<br><br><span style=""color:#06c; font-weight:bold;"">Obec</span> pořádá letní festival."	"municipality<br><br>The <span style=""color:#06c; font-weight:bold;"">municipality</span> organizes a summer festival."
"přítel<br><br>Můj nejlepší <span style=""color:#06c; font-weight:bold;"">přítel</span> bydlí daleko."	"friend<br><br>My best <span style=""color:#06c; font-weight:bold;"">friend</span> lives far away."
republika<br><br>Žijeme v České republice.	"republic<br><br>We live in the Czech <span style=""color:#06c; font-weight:bold;"">Republic</span>."
"proces<br><br>Učící <span style=""color:#06c; font-weight:bold;"">proces</span> trvá celý život."	"process<br><br>The learning <span style=""color:#06c; font-weight:bold;"">process</span> lasts a lifetime."
"skoro<br><br><span style=""color:#06c; font-weight:bold;"">Skoro</span> nikdo tam nepřišel."	"almost<br><br><span style=""color:#06c; font-weight:bold;"">Almost</span> nobody came there."
"hráč<br><br>Každý <span style=""color:#06c; font-weight:bold;"">hráč</span> má vlastní dres."	"player<br><br>Each <span style=""color:#06c; font-weight:bold;"">player</span> has his own jersey."
"soud<br><br><span style=""color:#06c; font-weight:bold;"">Soud</span> rozhodl ve prospěch obžalovaného."	"court<br><br>The <span style=""color:#06c; font-weight:bold;"">court</span> decided in favour of the defendant."
"napsat<br><br>Musím <span style=""color:#06c; font-weight:bold;"">napsat</span> dopis babičce."	to write down<br><br>I must write a letter to my grandma.
"výkon<br><br>Jeho <span style=""color:#06c; font-weight:bold;"">výkon</span> byl opravdu skvělý."	"performance<br><br>His <span style=""color:#06c; font-weight:bold;"">performance</span> was really great."
"trvat<br><br>Schůzka bude <span style=""color:#06c; font-weight:bold;"">trvat</span> asi hodinu."	to last<br><br>The meeting will last about an hour.
"syn<br><br>Jeho <span style=""color:#06c; font-weight:bold;"">syn</span> chodí do školky."	"son<br><br>His <span style=""color:#06c; font-weight:bold;"">son</span> goes to kindergarten."
"materiál<br><br>Potřebujeme nový stavební <span style=""color:#06c; font-weight:bold;"">materiál</span>."	"material<br><br>We need new building <span style=""color:#06c; font-weight:bold;"">material</span>."
rámec<br><br>Projekt běží v rámci školy.	"framework<br><br>The project runs within the <span style=""color:#06c; font-weight:bold;"">framework</span> of the school."
"politický<br><br>Sleduje <span style=""color:#06c; font-weight:bold;"">politický</span> vývoj v zemi."	"political<br><br>He follows the <span style=""color:#06c; font-weight:bold;"">political</span> developments in the country."
"poté<br><br>Nejdřív pojedeme na nákup a <span style=""color:#06c; font-weight:bold;"">poté</span> domů."	"afterwards<br><br>First we’ll go shopping and <span style=""color:#06c; font-weight:bold;"">afterwards</span> home."
"sem<br><br>Pojď <span style=""color:#06c; font-weight:bold;"">sem</span> a podívej se na to."	here (direction)<br><br>Come here and look at this.
"zajímavý<br><br>Byl to velmi <span style=""color:#06c; font-weight:bold;"">zajímavý</span> rozhovor."	"interesting<br><br>It was a very <span style=""color:#06c; font-weight:bold;"">interesting</span> conversation."
bůh<br><br>Věřil v jednoho boha.	"God<br><br>He believed in one <span style=""color:#06c; font-weight:bold;"">God</span>."
tvořit<br><br>Rád tvoří nové recepty.	to create<br><br>He likes creating new recipes.
bývat<br><br>Dřív býval hodně tichý.	"used to be<br><br>He <span style=""color:#06c; font-weight:bold;"">used to be</span> very quiet."
"model<br><br>Postavil <span style=""color:#06c; font-weight:bold;"">model</span> letadla z papíru."	"model<br><br>He built a <span style=""color:#06c; font-weight:bold;"">model</span> airplane from paper."
věnovat<br><br>Věnuje hodně času rodině.	to devote<br><br>He devotes a lot of time to his family.
"skutečně<br><br>Je to <span style=""color:#06c; font-weight:bold;"">skutečně</span> dobrý učitel."	really, truly<br><br>He really is a good teacher.
vydat<br><br>Nakladatelství vydalo novou knihu.	to publish, to issue<br><br>The publishing house released a new book.
"srdce<br><br>Cítím, jak mi bije <span style=""color:#06c; font-weight:bold;"">srdce</span>."	"heart<br><br>I feel my <span style=""color:#06c; font-weight:bold;"">heart</span> beating."
"postavit<br><br>Chtějí <span style=""color:#06c; font-weight:bold;"">postavit</span> nový most."	"to build<br><br>They want <span style=""color:#06c; font-weight:bold;"">to build</span> a new bridge."
"vlas<br><br>Na polštáři byl jeden <span style=""color:#06c; font-weight:bold;"">vlas</span>."	hair (strand)<br><br>There was one hair on the pillow.
autor<br><br>Je autorem několika článků.	"author<br><br>He is the <span style=""color:#06c; font-weight:bold;"">author</span> of several articles."
"konečně<br><br><span style=""color:#06c; font-weight:bold;"">Konečně</span> máme hotový projekt."	"finally<br><br>We <span style=""color:#06c; font-weight:bold;"">finally</span> have the project finished."
"láska<br><br>Jejich <span style=""color:#06c; font-weight:bold;"">láska</span> trvala mnoho let."	"love<br><br>Their <span style=""color:#06c; font-weight:bold;"">love</span> lasted many years."
"pražský<br><br>Má rád <span style=""color:#06c; font-weight:bold;"">pražský</span> humor."	Prague (adj.)<br><br>He likes Prague humour.
"pomoc<br><br>Děkuji za tvou <span style=""color:#06c; font-weight:bold;"">pomoc</span>."	"help<br><br>Thank you for your <span style=""color:#06c; font-weight:bold;"">help</span>."
"dodat<br><br>Chceš k tomu něco <span style=""color:#06c; font-weight:bold;"">dodat</span>?"	"to add<br><br>Do you want <span style=""color:#06c; font-weight:bold;"">to add</span> something to that?"
"polovina<br><br><span style=""color:#06c; font-weight:bold;"">Polovina</span> třídy je nemocná."	"half<br><br><span style=""color:#06c; font-weight:bold;"">Half</span> of the class is ill."
"veřejný<br><br>Je to <span style=""color:#06c; font-weight:bold;"">veřejný</span> park."	"public<br><br>It is a <span style=""color:#06c; font-weight:bold;"">public</span> park."
"nutný<br><br>Je <span style=""color:#06c; font-weight:bold;"">nutný</span> odpočinek."	"necessary<br><br>Rest is <span style=""color:#06c; font-weight:bold;"">necessary</span>."
"dílo<br><br>Tohle je jeho nejlepší <span style=""color:#06c; font-weight:bold;"">dílo</span>."	work (of art)<br><br>This is his best work.
"schopný<br><br>Je velmi <span style=""color:#06c; font-weight:bold;"">schopný</span> student."	"capable<br><br>He is a very <span style=""color:#06c; font-weight:bold;"">capable</span> student."
"strom<br><br>Před domem roste vysoký <span style=""color:#06c; font-weight:bold;"">strom</span>."	"tree<br><br>A tall <span style=""color:#06c; font-weight:bold;"">tree</span> grows in front of the house."
stránka<br><br>Otoč na další stránku.	page, side<br><br>Turn to the next page.
"rád<br><br>Jsem <span style=""color:#06c; font-weight:bold;"">rád</span>, že jsi přišel."	glad, fond of<br><br>I am glad you came.
"vytvořit<br><br>Chtějí <span style=""color:#06c; font-weight:bold;"">vytvořit</span> nový program."	"to create<br><br>They want <span style=""color:#06c; font-weight:bold;"">to create</span> a new program."
"příběh<br><br>Vyprávěl zajímavý <span style=""color:#06c; font-weight:bold;"">příběh</span> z dětství."	"story<br><br>He told an interesting <span style=""color:#06c; font-weight:bold;"">story</span> from childhood."
"zastavit<br><br>Musíme <span style=""color:#06c; font-weight:bold;"">zastavit</span> auto u kraje."	"to stop<br><br>We have <span style=""color:#06c; font-weight:bold;"">to stop</span> the car at the side."
jednoduchý<br><br>To cvičení je docela jednoduché.	"simple<br><br>This exercise is quite <span style=""color:#06c; font-weight:bold;"">simple</span>."
"vývoj<br><br>Sleduje <span style=""color:#06c; font-weight:bold;"">vývoj</span> ekonomiky."	"development<br><br>He follows the <span style=""color:#06c; font-weight:bold;"">development</span> of the economy."
tvrdit<br><br>Tvrdí, že má pravdu.	to claim<br><br>He claims that he is right.
"společný<br><br>Mají <span style=""color:#06c; font-weight:bold;"">společný</span> účet v bance."	common, shared<br><br>They have a joint bank account.
začátek<br><br>Na začátku roku je hodně práce.	"beginning<br><br>At the <span style=""color:#06c; font-weight:bold;"">beginning</span> of the year there is a lot of work."
"odejít<br><br>Musel <span style=""color:#06c; font-weight:bold;"">odejít</span> dřív z práce."	"to leave<br><br>He had <span style=""color:#06c; font-weight:bold;"">to leave</span> work early."
"pracovní<br><br>Má <span style=""color:#06c; font-weight:bold;"">pracovní</span> schůzku v deset hodin."	work (adj.)<br><br>He has a work meeting at ten o’clock.
